agility	su mem deo, linh hoat
beat	danh dap
blanket	chan
book	sach
computer	may tinh
culture	van hoa
damp	am uot
drastic	quyet liet
good afternoon	chao buoi chieu
good morning	chao buoi sang
hello	xin chao
house	ngoi nha
humanize	nhan hoa
irational	phi ly
leisure persuit	yeu thich
moisture	do am
monologue	doc thoai
monotonous	don dieu, chan
opponent	doi thu
opstacle	truong ngai vat
outweigh	vuot qua
perforated bag	tui co lo
service	dich vu
superior	sieu viet
table	ban
translate	dich
transport	giao thong van tai
unravel	lam sang to
violate	xam pham
